id	name	charge	formula	inchi	upa
pppg9_c	Protoporphyrinogen_IX				
hco3_c	HCO3_				
2ichor_c	2_amino_2_deoxyisochorismate				
lald_L_p	S__lactaldehyde				
actp_c	acetylphosphate				
glytrna_c	glycyl_tRNA_Gly_				
eig3p_c	D_erythro_imidazole_glycerol_phosphate				
h4mpt_c	tetrahydromethanopterin				
thex2eACP_c	trans_hex_2_enoyl__acyl_carrier_protein_				
lald_L_e	S__lactaldehyde				
mettrna_c	L_methionyl_tRNA_Met_				
3chd9ecoa_c	cis_3_cis_9_hexadecenoyl_CoA				
lald_L_c	S__lactaldehyde				
hgbam_c	hydrogenobyrinate_a_c_diamide				
ugmd_c	UDP_N_acetylmuramoyl_L_alanyl_D_glutamyl_meso_2_6_diaminopimelate				
cdd3ecoa_c	cis_dodec_3_enoyl_CoA				
2ahbut_c	2_aceto_2_hydroxy_butyrate				
phthr_c	4__phosphonooxy__threonine				
c2ch4cmo_c	2_chloro_cis_dienelactone				
trp_L_c	L_tryptophan				
quln_c	quinolinate				
trnaile_c	tRNA_Ile_				
dctp_c	dCTP				
ac_p	acetate				
prephyn_c	prephytoene_diphosphate				
asn_L_c	L_asparagine				
Ssact_c	sulfurated_sulfur_donor				
dhf_c	7_8_dihydrofolate				
pppi_c	triphosphate				
5mta_c	S__methyl_5__thioadenosine				
3hhdcoa_c	3S__3_hydroxyhexadecanoyl_CoA				
glu_D_c	D_glutamate				
2dhguln_c	2_keto_L_gulonate				
arab_D_p	D_arabinose				
2dda7p_c	3_deoxy_D_arabino_heptulosonate_7_phosphate				
fum_p	fumarate				
fum_c	fumarate				
26dap_M_c	meso_diaminoheptanedioate				
hisp_c	L_histidinol_phosphate				
fum_e	fumarate				
acac_e	acetoacetate				
acac_c	acetoacetate				
2Smsucccoa_c	2S__methylsuccinyl_CoA				
3oodcoa_c	3_oxooctadecanoyl_CoA				
u3aga_c	UDP_3_O__3_hydroxymyristoyl__N_acetylglucosamine				
4ppan_c	D__4__phosphopantothenate				
arab_D_e	D_arabinose				
trnaphe_c	tRNA_Phe_				
rdmbzi_c	a_ribazole				
tdeACP_c	cis_tetradec_7_enoyl__acyl_carrier_protein_				
ac_c	acetate				
ac_e	acetate				
R_3hcdd5ecoa_c	3R__3_hydroxy_cis_dodec_5_enoyl_CoA				
orot5p_c	orotidine_5__phosphate				
trnaser_c	tRNA_Ser_				
nicrnt_c	nicotinate_mononucleotide				
toct2eACP_c	trans_oct_2_enoyl__acyl_carrier_protein_				
mpe180_c	phosphatidyl_N_methylethanolamine_dioctadecanoyl_				
t3c9palmeACP_c	trans_3_cis_9_hexadecenoyl__acyl_carrier_protein_				
nad_c	NAD_				
acac_p	acetoacetate				
13dampp_c	1_3_diaminopropane				
odecoa_c	octadec_9_enoyl_CoA				
tyr_L_c	L_tyrosine				
ppcoa_c	propionyl_CoA				
oc2coa_c	trans_oct_2_enoyl_CoA				
dtbt_c	dethiobiotin				
clpnd181_c	cardiolipin_dioctadec_9_enoyl_				
glu_L_e	L_glutamate				
ribflv_c	riboflavin				
e4p_c	D_erythrose_4_phosphate				
1agpe160_c	1_hexadecanoyl_sn_glycero_3_phosphoethanolamine				
rmn_c	L_rhamnose				
glu_L_p	L_glutamate				
10fthf5glu_c	10_formyl_tetrahydropteroyl__gamma_Glu_5				
2agpe160_c	2_hexadecanoyl_sn_glycero_3_phosphoethanolamine				
sphedn_c	spheroidene				
co1dam_c	cob_I_yrinate_a_c_diamide				
uacgam_c	UDP_N_acetyl_D_glucosamine				
pe180_c	phosphatidylethanolamine_dioctadecanoyl_				
dmpp_c	dimethylallyl_diphosphate				
3opalmACP_c	3_oxohexadecanoyl__acyl_carrier_protein_				
glu_L_c	L_glutamate				
g3p_c	D_glyceraldehyde_3_phosphate				
aicar_c	aminoimidazole_carboxamide_ribonucleotide				
trnamet_c	tRNA_Met_				
dtpchptpp_c	di_trans_poly_cis_heptaprenyl_diphosphate				
ttdcea_c	7_tetradecenoate				
cdpddglc_c	CDP_4_dehydro_6_deoxy_D_glucose				
glc_D_c	D_glucose				
glc_D_e	D_glucose				
thmpp_c	thiamine_diphosphate				
thil_c	thiI				
pre3a_c	precorrin_3A				
4fumacac_c	4_fumaryl_acetoacetate				
4c2me_c	4__cytidine_5__diphospho__2_C_methyl_D_erythritol				
fe2_p	Fe2_				
acgam1p_c	N_acetyl_glucosamine_1_phosphate				
uaAgla_c	N_acetylmuramoyl_L_alanyl_D_glutamyl_L_lysyl_D_alanyl_D_alanine_diphosphoundecaprenol				
achms_c	O_acetyl_L_homoserine				
g3pe_c	sn_glycero_3_phosphoethanolamine				
10fthf_c	10_formyltetrahydrofolate				
hexdp_c	all_trans_hexaprenyl_diphosphate				
fe2_c	Fe2_				
fe2_e	Fe2_				
fdxrd_c	reduced_ferredoxin				
3cdd5ecoa_c	cis_3_cis_5_dodecenoyl_CoA				
4mpetz_c	4_methyl_5__b_hydroxyethyl_thiazole_phosphate				
tcynt_c	thiocyanate				
mred_c	methyl_red				
trnaleu_c	tRNA_Leu_				
creat_c	creatine				
grdp_c	geranyl_diphosphate				
orot_c	orotate				
2pg_c	2_phospho_D_glycerate				
butACP_c	butyryl__acyl_carrier_protein_				
4ampm_c	hydroxymethylpyrimidine_phosphate				
dpcoa_c	dephospho_CoA				
dhrdpin_c	3_4_dehydrorhodopin				
2agpe180_c	2_octadecanoyl_sn_glycero_3_phosphoethanolamine				
3ochd9ecoa_c	3_oxo_cis_hexadec_9_enoyl_CoA				
23dhdp_c	dihydrodipicolinate				
pmcoa_c	6_carboxyhexanoyl_CoA				
valtrna_c	L_valyl_tRNA_Val_				
succoa_c	succinyl_CoA				
trnahis_c	tRNA_His_				
polypi_c	polyphosphate				
thf6glu_c	tetrahydropteroyl__gamma_Glu_6				
focytc_c	reduced_cytochrome_c				
dhpt_c	7_8_dihydropteroate				
sorbnl_L_c	L_sorbosone_2_6_lactone				
3dhq_c	3_dehydroquinate				
fadh2_c	FADH2				
3psme_c	5_enolpyruvylshikimate_3_phosphate				
phe_L_c	L_phenylalanine				
R_3hhdccoa_c	3R__3_hydroxyhexadecanoyl_CoA				
pg161_c	phosphatidylglycerol_dihexadec_9_enoyl_				
damp_c	dAMP				
dadp_c	dADP				
lys_L_c	L_lysine				
udpgal_c	UDP_galactose				
12ppd_S_e	1_2_propanediol				
gcald_c	glycolaldehyde				
clac_c	chloroacetate				
pmtcoa_c	hexadecanoyl_CoA				
uAgla_c	UDP_N_acetylmuramoyl_L_alanyl_D_glutamyl_L_lysyl_D_alanyl_D_alanine				
hneuropn_c	hydroxyneurosporene				
12ppd_S_p	1_2_propanediol				
3hcdd5ecoa_c	3S__3_hydroxy_cis_dodec_5_enoyl_CoA				
R_3hchd9ecoa_c	3R__3_hydroxy_cis_hexadec_9_enoyl_CoA				
ttdca_c	tetradecanoate				
trnatyr_c	tRNA_Tyr_				
3ocpalm9eACP_c	3_oxo_cis_hexadec_9_enoyl__acyl_carrier_protein_				
btcoa_c	butyryl_CoA				
protrna_c	L_prolyl_tRNA_Pro_				
dcamp_c	adenylo_succinate				
ps180_c	phosphatidyl_L_serine_dioctadecanoyl_				
dmtsphedn_c	demethylspheroidene				
prbamp_c	phosphoribosyl_AMP				
toctd2eACP_c	trans_octadec_2_enoyl__acyl_carrier_protein_				
so3_c	HSO3_				
glutrna_c	L_glutamyl_tRNA_Glu_				
prpp_c	5_phosphoribosyl_1_pyrophosphate				
mlthf_c	5_10_methylenetetrahydrofolate				
imacp_c	imidazol_acetol_phosphate				
mg2_c	Mg2_				
mg2_e	Mg2_				
apoACP_c	apo__acyl_carrier_protein_				
3ooctdACP_c	3_oxooctadecanoyl__acyl_carrier_protein_				
ade_c	adenine				
ps161_c	phosphatidyl_L_serine_dihexadec_9_enoyl_				
phez1c_c	phenazine_1_carboxylate				
u23ga_c	UDP_2_3_bis_3_hydroxymyristoyl_glucosamine				
2agpc160_c	2_hexadecanoyl_sn_glycero_3_phosphocholine				
mg2_p	Mg2_				
dtpcdcpp_c	di_trans_poly_cis_decaprenyldiphosphate				
myrsACP_c	tetradecanoyl__acyl_carrier_protein_				
glyc2p_c	glycerol_2_phosphate				
glucys_c	gamma_L_glutamyl_L_cysteine				
this_c	thiS				
prbatp_c	phosphoribosyl_ATP				
cit_p	citrate				
2dmmq8_c	demethylmenaquinone_8				
precZ_c	precursor_Z				
trnagly_c	tRNA_Gly_				
trnapro_c	tRNA_Pro_				
cit_e	citrate				
cit_c	citrate				
iletrna_c	L_isoleucyl_tRNA_Ile_				
met_L_c	L_methionine				
histda_c	histidinal				
pgp160_c	phosphatidylglycerolphosphate_dihexadecanoyl_				
fprica_c	phosphoribosyl_formamido_carboxamide				
scl_c	sirohydrochlorin				
3oddecACP_c	3_oxododecanoyl__acyl_carrier_protein_				
pre6b_c	precorrin_6B				
R_3hdcoa_c	3R__3_hydroxydecanoyl_CoA				
malScoa_c	S__malyl_CoA				
dhor_S_c	dihydroorotate				
pg180_c	phosphatidylglycerol_dioctadecanoyl_				
4abz_c	p_aminobenzoate				
sarcs_c	sarcosine				
trnaasp_c	tRNA_Asp_				
fdxox_c	oxidized_ferredoxin				
gtp_c	GTP				
kdo8p_c	3_deoxy_D_manno_octulosonate_8_P				
adn_c	adenosine				
2agpc180_c	2_octadecanoyl_sn_glycero_3_phosphocholine				
tartr_L_e	L_tartrate				
aspsa_c	L_aspartate_4_semialdehyde				
2Sethmalcoa_c	2S__ethylmalonyl_CoA				
tartr_L_c	L_tartrate				
tartr_L_p	L_tartrate				
thr_L_c	L_threonine				
trnaasn_c	tRNA_Asn_				
gly_c	glycine				
R_3hbacp_c	3R__3_hydroxybutanoyl__acyl_carrier_protein_				
cys_L_c	L_cysteine				
t3c5ddeceACP_c	trans_3_cis_5_dodecenoyl__acyl_carrier_protein_				
3ocdd5ecoa_c	3_oxo_cis_dodec_5_enoyl_CoA				
t3coctd11ecoa_c	trans_3_cis_11_octadecenoyl_CoA				
co2dam_c	cob_II_yrinate_a_c_diamide				
mlthf5glu_c	methylene_tetrahydropteroyl__gamma_Glu_5				
man1p_c	D_mannose_1_phosphate				
pant_R_c	L_pantoate				
R_3hctd7ecoa_c	3R__3_hydroxy_cis_tetradec_7_enoyl_CoA				
pi_p	phosphate				
acald_c	acetaldehyde				
ocdceap_c	octadec_9_enoyl_phosphate				
5dr1p_c	5__deoxyribose_1_phosphate				
glcn_p	D_gluconate				
pi_e	phosphate				
pyam5p_c	pyridoxamine_5__phosphate				
gsn_c	guanosine				
R_3hhc_c	3R__3_hydroxyhexanoate				
tsul_p	thiosulfate				
glcn_e	D_gluconate				
mvpclphd_c	monovinyl_protochlorophyllidea				
3hcvac11eACP_c	3R__3_hydroxy_cis_octadec_11_enoyl__acyl_carrier_protein_				
pi_c	phosphate				
acald_p	acetaldehyde				
tsul_e	thiosulfate				
pgp181_c	phosphatidylglycerolphosphate_dioctadec_9_enoyl_				
glcn_c	D_gluconate				
t2ctd7ecoa_c	trans_2_cis_7_tetradecenoyl_CoA				
malcoa_c	malonyl_CoA				
cbasp_c	N_carbamoyl_L_aspartate				
5aizc_c	4_carboxyaminoimidazole_ribonucleotide				
Brfap_c	4__b_D_ribofuranosyl_aminobenzene_5__phosphate				
ca2_p	Ca2_				
ugmda_c	UDP_N_acetylmuramoyl_L_alanyl_D_glutamyl_meso_2_6_diaminopimelyl_D_alanyl_D_alanine				
cdpdhdecg_c	CDP_1_2_dihexadecanoyl_glycerol				
pyr_p	pyruvate				
6hmhpt_c	6_hydroxymethyl_7_8_dihydropterin				
8aonn_c	7_keto_8_aminopelargonate				
cddec5eACP_c	cis_dodec_5_enoyl__acyl_carrier_protein_				
3hhcoa_c	3S__3_hydroxyhexanoyl_CoA				
ca2_c	Ca2_				
ctd3ecoa_c	cis_tetradec_3_enoyl_CoA				
cobalt2_e	Co2_				
cobalt2_c	Co2_				
cobalt2_p	Co2_				
hcys_L_c	L_homocysteine				
ca2_e	Ca2_				
pre4_c	precorrin_4				
asntrna_c	L_asparaginyl_tRNA_Asn_				
R_3hddcoa_c	3R__3_hydroxydodecanoyl_CoA				
mptS_c	molybdopterin_synthase				
23dhmb_c	2_3_dihydroxy_isovalerate				
adocbl_c	coenzyme_B12				
3ohexACP_c	3_oxohexanoyl__acyl_carrier_protein_				
dtpchxapp_c	di_trans_poly_cis_hexaprenyl_diphosphate				
uppg3_c	uroporphyrinogen_III				
trnalys_c	tRNA_Lys_				
oaa_c	oxaloacetate				
2pglyc_c	2_phosphoglycolate				
trnathr_c	tRNA_Thr_				
pyr_e	pyruvate				
cdpdodecg_c	CDP_1_2_dioctadecanoyl_glycerol				
s7p_c	sedoheptulose_7_phosphate				
pyr_c	pyruvate				
uaccg_c	UDP_N_acetyl_3_O__1_carboxyvinyl__D_glucosamine				
icit_c	threo_D_isocitrate				
2Rethmalcoa_c	2R__ethylmalonyl_CoA				
fad_c	FAD				
N1aspmd_c	N_acetylspermidine				
mmcoa_R_c	R__methylmalonyl_CoA				
spmd_c	spermidine				
R_3hoctdc_c	3R__3_hydroxyoctadecanoate				
btn_c	biotin				
2ippa_c	2S__2_isopropylmalate				
arog_c	L_arogenate				
thdp_c	tetrahydrodipicolinate				
val_L_c	L_valine				
hdceap_c	hexadec_9_enoyl_phosphate				
etha_e	ethanolamine				
fald_p	formaldehyde				
fdp_c	D_fructose_1_6_bisphosphate				
adocblp_c	adenosylcobalamin_5__phosphate				
meoh_p	methanol				
hpyr_c	hydroxypyruvate				
trnagln_c	tRNA_Gln_				
etha_p	ethanolamine				
r5p_c	D_ribose_5_phosphate				
3hoctACP_c	3R__3_hydroxyoctanoyl__acyl_carrier_protein_				
his_L_c	L_histidine				
meoh_e	methanol				
mlthf6glu_c	methylene_tetrahydropteroyl__gamma_Glu_6				
fald_e	formaldehyde				
fald_c	formaldehyde				
mptamp_c	molybdopterin_AMP				
hemeO_c	heme_o				
dhnpt_c	7_8_dihydro_D_neopterin				
h2mpt_c	7_8_dihydromethanopterin				
ru5p_D_c	D_ribulose_5_phosphate				
23dpg_c	2_3_bisphospho_D_glycerate				
t3c7mrseACP_c	trans_3_cis_7_tetradecenoyl__acyl_carrier_protein_				
3oocoa_c	3_oxooctanoyl_CoA				
1agpe181_c	1_octadec_9_enoyl_sn_glycero_3_phosphoethanolamine				
ser_D_c	D_serine				
xtsn_c	xanthosine				
mlh4mpt_c	5_10_methylenetetrahydromethanopterin				
suchms_c	O_succinyl_L_homoserine				
uamag_c	UDP_N_acetylmuramoyl_L_alanyl_D_glutamate				
cl_c	Cl_				
alaLgluD_c	L_Ala_D_Glu				
mpe160_c	phosphatidyl_N_methylethanolamine_dihexadecanoyl_				
gudac_c	guanidinoacetate				
cl_e	Cl_				
lyxnt_e	L_lyxonate				
k_p	K_				
23dh3oxanth_c	2_3_dihydro_3_oxo_anthranilate				
6hmhptpp_c	6_hydroxymethyl_dihydropterin_diphosphate				
dc2coa_c	trans_dec_2_enoyl_CoA				
ump_c	UMP				
2ommbl_c	2_octaprenyl_3_methyl_6_methoxy_1_4_benzoquinol				
cl_p	Cl_				
lyxnt_p	L_lyxonate				
3hcpalm9eACP_c	3R__3_hydroxy_cis_hexadec_9_enoyl__acyl_carrier_protein_				
argtrna_c	L_arginyl_tRNA_Arg_				
rib_D_p	D_ribose				
lystrna_c	L_lysyl_tRNA_Lys_				
thrtrna_c	L_threonyl_tRNA_Thr_				
23dhmp_c	2_3_dihydroxy_3_methylvalerate				
trdrd_c	reduced_thioredoxin				
rib_D_e	D_ribose				
acser_c	O_acetyl_L_serine				
arg_L_c	L_arginine				
3hddcoa_c	3S__3_hydroxydodecanoyl_CoA				
dttp_c	dTTP				
k_e	K_				
dhrdvbin_c	3__4__dihydrorhodovibrin				
k_c	K_				
pbhb_c	Poly_beta_hydroxybutyrate				
t3c11vaceACP_c	trans_3_cis_11_octadecenoyl__acyl_carrier_protein_				
kdo_c	3_deoxy_D_manno_octulosonate				
applp_c	R__1_amino_2_propanol_O_2_phosphate				
dtdpglu_c	dTDP_glucose				
pa160_c	1_2_dihexadecanoyl_sn_glycerol_3_phosphate				
octdp_c	all_trans_octaprenyl_diphosphate				
2agpe181_c	2_octadec_9_enoyl_sn_glycero_3_phosphoethanolamine				
c4cmbo_c	cis_dienelactone				
lac_L_e	S__lactate				
Nforglu_c	N_formyl_L_glutamate				
lac_L_c	S__lactate				
3mop_c	2_keto_3_methyl_valerate				
cbl1_c	cob_I_alamin				
dcaACP_c	decanoyl__acyl_carrier_protein_				
pSamdhll_c	H_protein_S__aminomethyldihydrolipoyl_lysine				
3ophb_c	3_octaprenyl_4_hydroxybenzoate				
tlycopn_c	trans_lycopene				
tlycopn_e	trans_lycopene				
3hcddec5eACP_c	3R__3_hydroxy_cis_dodec_5_enoyl__acyl_carrier_protein_				
pser_D_c	O_phospho_D_serine				
kdolipid4_c	KDO__lipid_IVA				
lac_L_p	S__lactate				
1odec11eg3p_c	1_octadec_9_enoyl_sn_glycerol_3_phosphate				
hdd2coa_c	trans_hexadec_2_enoyl_CoA				
hdcea_c	9_hexadecenoate				
cdpdodec11eg_c	CDP_1_2_dioctadec_9_enoyl_glycerol				
phom_c	O_phospho_L_homoserine				
3omrsACP_c	3_oxotetradecanoyl__acyl_carrier_protein_				
5prdmbz_c	a_ribazole_5__P				
ocACP_c	octanoyl__acyl_carrier_protein_				
3ocddec5eACP_c	3_oxo_cis_dodec_5_enoyl__acyl_carrier_protein_				
R_3hcoctd11ecoa_c	3R__3_hydroxy_cis_octadec_11_enoyl_CoA				
prlp_c	phosphoribulosylformimino_AICAR_phosphate				
3odcoa_c	3_oxodecanoyl_CoA				
lipidA_c	lipid_IVA				
succ_e	succinate				
dhanrdvbin_c	3_4_dihydroanhydrorhodovibrin				
succ_c	succinate				
5mdr1p_c	S__methyl_5_thio_alpha_D_ribose_1_phosphate				
3hmrsACP_c	3R__3_hydroxytetradecanoyl__acyl_carrier_protein_				
cdpdhdec9eg_c	CDP_1_2_dihexadec_9_enoyl_glycerol				
glyc_c	glycerol				
gam6p_c	D_glucosamine_6_phosphate				
4pasp_c	L_aspartyl_4_phosphate				
ocdca_c	octadecanoate				
13dpg_c	3_phospho_D_glyceroylphosphate				
2omph_c	2_octaprenyl_6_methoxyphenol				
chd3ecoa_c	cis_hexadec_3_enoyl_CoA				
ddc5e_c	5_dodecenoate				
histd_c	L_histidinol				
3c4mop_c	2_isopropyl_3_oxosuccinate				
mma_p	methylamine				
3hchd9ecoa_c	3S__3_hydroxy_cis_hexadec_9_enoyl_CoA				
succ_p	succinate				
neuropn_e	neurosporene				
nadh_c	NADH				
tre_c	trehalose				
mi3p_D_c	D_myo_inositol_3_monophosphate				
3ococtd11ecoa_c	3_oxo_cis_octadec_11_enoyl_CoA				
neuropn_c	neurosporene				
adocbi_c	adenosylcobinamide				
2mecdp_c	2_C_methyl_D_erythritol_2_4_cyclodiphosphate				
glyc_R_c	D_glycerate				
23dh3hxanth_c	2_3_dihydro_3_hydroxy_anthranilate				
no2_c	NO2_				
5dglcn_c	5_dehydro_D_gluconate				
photon_c	photon				
5dglcn_e	5_dehydro_D_gluconate				
hemeD_c	heme_d				
10fthf6glu_c	10_formyl_tetrahydropteroyl__gamma_Glu_6				
hom_L_c	L_homoserine				
gdpfuc_c	GDP_fucose				
leutrna_c	L_leucyl_tRNA_Leu_				
no2_p	NO2_				
sheme_c	siroheme				
urea_c	urea				
q_c	UQ				
coctd3ecoa_c	cis_octadec_3_enoyl_CoA				
dudp_c	dUDP				
1agpc160_c	1_hexadecanoyl_sn_glycero_3_phosphocholine				
leu_L_c	L_leucine				
acACP_c	acetyl__acyl_carrier_protein_				
ahcys_c	S__adenosyl_L_homocysteine				
rbrdxOX_c	oxidized_rubredoxin				
argsuc_c	L_arginino_succinate				
zn2_p	Zn2_				
gln_L_c	L_glutamine				
gdpddman_c	GDP_4_dehydro_6_deoxy_D_mannose				
glntrna_c	L_glutaminyl_tRNA_Gln_				
zn2_c	Zn2_				
uaagmda_c	N_acetylmuramoyl_L_alanyl_D_glutamyl_meso_2_6_diaminopimelyl_D_alanyl_D_alanine_diphosphoundecaprenyl_N_acetylglucosamine				
2mac_c	2_maleylacetate				
zn2_e	Zn2_				
sl26da_c	N_succinyl_L_L_2_6_diaminopimelate				
cdec3eACP_c	cis_dec_3_enoyl__acyl_carrier_protein_				
acmalt_c	acetylmaltose				
rdEA_e	reduced_electron_acceptor				
rdEA_c	reduced_electron_acceptor				
ametam_c	S__adenosylmethioninamine				
tddec2eACP_c	trans_dodec_2_enoyl__acyl_carrier_protein_				
meh4mpt_c	5_10_methenyltetrahydromethanopterin				
iasp_c	a_iminosuccinate				
uamr_c	UDP_N_acetylmuramate				
methf_c	5_10_methenyltetrahydrofolate				
o2s_c	superoxide				
pap_c	adenosine_3__5__bisphosphate				
pep_c	phosphoenolpyruvate				
agdpcbi_c	adenosylcobinamide_GDP				
3coctd11ecoa_c	cis_3_cis_11_octadecenoyl_CoA				
gdpmann_c	GDP_mannose				
formmfr_b__c	formylmethanofuran				
chol_c	choline				
mptSs_c	sulfurated_molybdopterin_synthase				
hmbil_c	hydroxymethylbilane				
xu5p_D_c	D_xylulose_5_phosphate				
6pthp_c	6_pyruvoyl_tetrahydropterin				
5dglcn_p	5_dehydro_D_gluconate				
g6p_c	D_glucose_6_phosphate				
26dap_LL_c	LL_2_6_diaminoheptanedioate				
R_3hddc_c	3R__3_hydroxydodecanoate				
pram_c	5_phospho_beta_D_ribosylamine				
pe160_c	phosphatidylethanolamine_dihexadecanoyl_				
trptrna_c	L_tryptophyl_tRNA_Trp_				
dmuqh2_c	3_demethylubiquinol_8				
3mob_c	3_methyl_2_oxobutanoate				
4adcho_c	4_amino_4_deoxychorismate				
hxysplxanth_c	hydroxyspirilloxanthin				
ribona_p	D_ribonate				
ins_c	inosine				
2agpe161_c	2_hexadec_9_enoyl_sn_glycero_3_phosphoethanolamine				
14bglu_c	1_4_beta_D_glucosyl_10u_				
dmlz_c	6_7_dimethyl_8__1_D_ribityl_lumazine				
phetrna_c	L_phenylalanyl_tRNA_Phe_				
pan4p_c	4__phosphopantetheine				
ribona_e	D_ribonate				
3hddecACP_c	3R__3_hydroxydodecanoyl__acyl_carrier_protein_				
pa181_c	1_2_dioctadec_9_enoyl_sn_glycerol_3_phosphate				
pre1_c	precorrin_1				
pg181_c	phosphatidylglycerol_dioctadec_9_enoyl_				
3hdecACP_c	3R__3_hydroxydecanoyl__acyl_carrier_protein_				
aps_c	adenosine_5__phosphosulfate				
ppbng_c	porphobilinogen				
hcl_c	HCl				
accoa_c	acetyl_CoA				
coct3ecoa_c	cis_oct_3_enoyl_CoA				
adcobhex_c	adenosyl_cobyrate				
3hhexACP_c	3R__3_hydroxyhexanoyl__acyl_carrier_protein_				
5aprbu_c	5_amino_6_ribitylamino_2_4_1H_3H__pyrimidinedione_5__phosphate				
dtdp4d6dm_c	dTDP_4_dehydro_6_deoxy_L_mannose				
paps_c	phosphoadenosine_5__phosphosulfate				
oxalcoa_c	oxalyl_CoA				
xylnt_D_p	D_xylonate				
anth_c	anthranilate				
1hdec9eg3p_c	1_hexadec_9_enoyl_sn_glycerol_3_phosphate				
asp_L_e	L_aspartate				
4r5au_c	5_amino_6_ribitylamino_2_4_1H_3H__pyrimidinedione				
asp_L_c	L_aspartate				
so4_p	SO42_				
amet_c	S__adenosyl_L_methionine				
so4_c	SO42_				
thrp_c	L_threonine_O_3_phosphate				
so4_e	SO42_				
ch3ecoa_c	cis_hex_3_enoyl_CoA				
xylnt_D_e	D_xylonate				
vnaccoa_c	vinylacetyl_CoA				
acgam6p_c	N_acetyl_D_glucosamine_6_phosphate				
thf_c	tetrahydrofolate				
t3ctd7ecoa_c	trans_3_cis_7_tetradecenoyl_CoA				
R_3hhcoa_c	3R__3_hydroxyhexanoyl_CoA				
dtdprmn_c	dTDP_a_L_rhamnose				
mpe181_c	phosphatidyl_N_methylethanolamine_dioctadec_9_enoyl_				
thif_c	thiF				
nac_c	nicotinate				
utp_c	UTP				
oxa_p	oxalate				
R_3hhdc_c	3R__3_hydroxyhexadecanoate				
2agpc181_c	2_octadec_9_enoyl_sn_glycero_3_phosphocholine				
oxa_e	oxalate				
occoa_c	octanoyl_CoA				
alatrna_c	L_alanyl_tRNA_Ala_				
glyc3p_c	sn_glycerol_3_phosphate				
oxa_c	oxalate				
R_3htdc_c	3R__3_hydroxytetradecanoate				
dann_c	7_8_diaminopelargonate				
dnad_c	nicotinate_adenine_dinucleotide				
crtn_c	creatinine				
dxyl5p_c	1_deoxy_D_xylulose_5_phosphate				
hexACP_c	hexanoyl__acyl_carrier_protein_				
prfp_c	phosphoribosylformimino_AICAR_phosphate				
td2coa_c	trans_tetradec_2_enoyl_CoA				
clpnd180_c	cardiolipin_dioctadecanoyl_				
crm_c	ceramide				
rb15bp_c	D_ribulose_1_5_bisphosphate				
mpt_c	molybdopterin				
pe181_c	phosphatidylethanolamine_dioctadec_9_enoyl_				
orn_c	L_ornithine				
t2chd9ecoa_c	trans_2_cis_9_hexadecenoyl_CoA				
dscl_c	precorrin_2				
ocdcaACP_c	octadecanoyl__acyl_carrier_protein_				
ocdcea_c	9_octadecenoate				
cdd5ecoa_c	cis_dodec_5_enoyl_CoA				
dca_p	decanoate				
xyl_D_e	D_xylose				
xyl_D_p	D_xylose				
histrna_c	L_histidyl_tRNA_His_				
thilps_c	thiI_persulfide				
3hcmrs7eACP_c	3R__3_hydroxy_cis_tetradec_7_enoyl__acyl_carrier_protein_				
ala_B_c	b_alanine				
dca_e	decanoate				
3hocoa_c	3S__3_hydroxyoctanoyl_CoA				
dca_c	decanoate				
acetmurpentpeptdpdcp_c	N_acetylmuramoyl_pentapeptide_diphosphoundecaprenol				
R_3hmrscoa_c	3R__3_hydroxytetradecanoyl_CoA				
fpram_c	5_phosphoribosyl_N_formylglycineamidine				
lgt_S_c	S_lactoylglutathione				
dahetbclphd_c	2_desacetyl_2_hydroxyethyl_bacteriochlorophyllidea				
udp_c	UDP				
metmetacc_c	methylated_methyl_acceptor				
pser_L_c	3_phospho_L_serine				
dmetmetacc_c	demethylated_methyl_acceptor				
cyan_c	cyanide				
hdca_c	hexadecanoate				
mtoxneuropn_c	methoxyneurosporene				
ppap_c	propionylphosphate				
dgtp_c	dGTP				
sucorn_c	N2_succinyl_L_ornithine				
mma_e	methylamine				
3hbcoa_c	S__3_hydroxybutanoyl_CoA				
akg_c	2_oxoglutarate				
lyx_L_p	L_lyxose				
mma_c	methylamine				
uSsact_c	unsulfurated_sulfur_acceptor				
lipidX_c	2_3_bis_3_hydroxymyristoyl__b_D_glucosaminyl_1_phosphate				
akg_e	2_oxoglutarate				
lyx_L_e	L_lyxose				
akg_p	2_oxoglutarate				
ddca_c	dodecanoate				
t3cdd5ecoa_c	trans_3_cis_5_dodecenoyl_CoA				
malACP_c	malonyl__acyl_carrier_protein_				
5mthf_c	5_methyltetrahydrofolate				
1pyr5c_c	S__1_pyrroline_5_carboxylate				
udpg_c	UDP_glucose				
2me4p_c	2_C_methyl_D_erythritol_4_phosphate				
no_c	NO				
lipidAds_c	lipid_A_disaccharide				
gthrd_c	glutathione				
pro_L_c	L_proline				
pnto_R_c	R__pantothenate				
3hdcoa_c	3S__3_hydroxydecanoyl_CoA				
mqn8_c	menaquinone_8				
air_c	5_aminoimidazole_ribonucleotide				
mfr_b__c	methanofuran				
but_c	butyrate				
3ocmrs7eACP_c	3_oxo_cis_tetradec_7_enoyl__acyl_carrier_protein_				
dhpmp_c	dihydroneopterin_phosphate				
glu5p_c	L_glutamate_5_phosphate				
dgdp_c	dGDP				
pg160_c	phosphatidylglycerol_dihexadecanoyl_				
ctp_c	CTP				
pre6a_c	precorrin_6A				
alaala_c	D_alanyl_D_alanine				
alagDgluDAPDala_c	L_Ala_gamma_D_Glu_DAP_D_Ala				
thisamp_c	adenylated_thiS				
3hcoctd11ecoa_c	3S__3_hydroxy_cis_octadec_11_enoyl_CoA				
dgmp_c	dGMP				
3pg_c	3_phospho_D_glycerate				
bmmalcoa_c	erythro_b_methylmalyl_CoA				
imgly_c	iminoglycine				
ps181_c	phosphatidyl_L_serine_dioctadec_9_enoyl_				
r1p_c	alpha_D_ribose_1_phosphate				
octa_c	octanoate				
2cpr5p_c	1__2_carboxyphenylamino__1_deoxy_D_ribulose_5_phosphate				
acg5sa_c	N_acetyl_L_glutamate_5_semialdehyde				
dtdp_c	dTDP				
1agpc181_c	1_octadec_9_enoyl_sn_glycero_3_phosphocholine				
dcmp_c	dCMP				
ddcacoa_c	dodecanoyl_CoA				
glutrna_gln__c	L_glutamyl_tRNA_Gln_				
na1_c	Na_				
na1_e	Na_				
na1_p	Na_				
dhap_c	glycerone_phosphate				
25drapp_c	2_5_diamino_6__ribosylamino__4__3H__pyrimidinone_5__phosphate				
zcar_e	zeta_carotene				
thisthilads_c	thiS_thiI_acyl_disulfide				
zcar_c	zeta_carotene				
3ocvac11eACP_c	3_oxo_cis_octadec_11_enoyl__acyl_carrier_protein_				
3ooctACP_c	3_oxooctanoyl__acyl_carrier_protein_				
fmn_c	FMN				
sucsal_c	succinate_semialdehyde				
tyrtrna_c	L_tyrosyl_tRNA_Tyr_				
dcdp_c	dCDP				
thf5glu_c	tetrahydropteroyl__gamma_Glu_5				
tdec2eACP_c	trans_dec_2_enoyl__acyl_carrier_protein_				
GlcNacanhMurNac_c	GlcNAc_1_6_anhMurNAc				
datp_c	dATP				
etha_c	ethanolamine				
etgly_c	N_ethylglycine				
ala_L_c	L_alanine				
gmp_c	GMP				
clpnd160_c	cardiolipin_dihexadecanoyl_				
trnacys_c	tRNA_Cys_				
ahdt_c	7_8_dihydroneopterin_triphosphate				
pgp161_c	phosphatidylglycerolphosphate_dihexadec_9_enoyl_				
3hpalmACP_c	3R__3_hydroxyhexadecanoyl__acyl_carrier_protein_				
nh4_p	NH3				
chor_c	chorismate				
phyflun_c	phytofluene				
but2eACP_c	crotonyl__acyl_carrier_protein_				
phyflun_e	phytofluene				
asptrna_asn_c	L_aspartyl_tRNA_Asn_				
nh4_e	NH3				
4ahmmp_c	hydroxymethylpyrimidine				
acg5p_c	N_acetylglutamyl_phosphate				
nh4_c	NH3				
dtpcoctpp_c	di_trans_poly_cis_octaprenyl_diphosphate				
2mahmp_c	4_amino_5_hydroxymethyl_2_methylpyrimidine_pyrophosphate				
4ppcys_c	R__4__phosphopantothenoyl_L_cysteine				
acgam_c	N_acetyl_D_glucosamine				
3dhsk_c	3_dehydroshikimate				
hepdp_c	all_trans_heptaprenyl_diphosphate				
pre8_c	precorrin_8x				
fmettrna_c	N_formylmethionyl_tRNA_fMet_				
t3chd9ecoa_c	trans_3_cis_9_hexadecenoyl_CoA				
t2cdd5ecoa_c	trans_2_cis_5_dodecenoyl_CoA				
ala_D_c	D_alanine				
3php_c	3_phospho_hydroxypyruvate				
hspmd_c	sym_homospermidine				
araba_e	L_arabinonate				
ncam_c	nicotinamide				
rETF_c	reduced_ETF				
R_3hoctdccoa_c	3R__3_hydroxyoctadecanoyl_CoA				
ps160_c	phosphatidyl_L_serine_dihexadecanoyl_				
man6p_c	D_mannose_6_phosphate				
glx_c	glyoxylate				
araba_p	L_arabinonate				
5apru_c	5_amino_6__5__phosphoribosylamino_uracil				
moco_c	molybdenum_cofactor				
3oddcoa_c	3_oxododecanoyl_CoA				
bclphd_c	bacteriochlorophyllidea				
ppi_c	diphosphate				
mpe161_c	phosphatidyl_N_methylethanolamine_dihexadec_9_enoyl_				
cyst_L_c	L_cystathionine				
2kdrib_e	2_deoxy_D_ribose				
pendp_c	geranylfarnesyl_diphosphate				
ACP_c	acyl_carrier_protein_				
4mop_c	4_methyl_2_oxopentanoate				
od2coa_c	trans_octadec_2_enoyl_CoA				
cbp_c	carbamoyl_phosphate				
1hdecg3p_c	1_hexadecanoyl_sn_glycerol_3_phosphate				
3ohdcoa_c	3_oxohexadecanoyl_CoA				
cobya_c	cobyrinate				
dad_2_c	5__deoxyadenosine				
co2_c	CO2				
cmp_c	CMP				
co2_e	CO2				
2h3oppan_c	tartronate_semialdehyde				
dpundcpGlcNacMurNacpentpept_c	diphosphoundecaprenyl__GlcNAc_MurNAc_pentapeptide				
xmp_c	XMP				
ethlam_c	ethylamine				
adcobdam_c	adenosyl_cobyrinate_a_c_diamide				
amp_c	AMP				
nigos_c	nigerose				
sucgsa_c	N2_succinyl_L_glutamate_5_semialdehyde				
phpyr_c	phenylpyruvate				
pre5_c	precorrin_5				
34thsplxanth_c	3_4_3__4__tetrahydrospirilloxanthin				
hx2coa_c	trans_hex_2_enoyl_CoA				
glyclt_e	glycolate				
db4p_c	L_3_4_dihydroxybutan_2_one_4_phosphate				
b2coa_c	crotonyl_CoA				
3a2op_c	1_amino_propan_2_one_3_phosphate				
glyclt_c	glycolate				
gthox_c	glutathione_disulfide				
h2mb4p_c	1_hydroxy_2_methyl_2__E__butenyl_4_diphosphate				
etma_p	ethylamine				
cbi_c	cobinamide				
3hctd7ecoa_c	3S__3_hydroxy_cis_tetradec_7_enoyl_CoA				
acglu_c	N_acetyl_L_glutamate				
h4pt_c	5_6_7_8_tetrahydropteridine				
galcDarab_p	3_O_b_D_galactopyranosyl_D_arabinose				
2agpc161_c	2_hexadec_9_enoyl_sn_glycero_3_phosphocholine				
co2_p	CO2				
uama_c	UDP_N_acetylmuramoyl_L_alanine				
glyclt_p	glycolate				
ppa_p	propanoate				
clpnd161_c	cardiolipin_dihexadec_9_enoyl_				
alaglu_c	L_Ala_L_Glu				
trnaala_c	tRNA_Ala_				
5aop_c	5_aminolevulinate				
ipdp_c	isopentenyl_diphosphate				
tcmbo_c	trans_dienelactone				
adocbip_c	adenosyl_cobinamide_phosphate				
galcDarab_e	3_O_b_D_galactopyranosyl_D_arabinose				
hdcoa_c	hexadec_9_enoyl_CoA				
mmcoa_S_c	S__methylmalonyl_CoA				
ppa_e	propanoate				
ptrc_p	putrescine				
pe161_c	phosphatidylethanolamine_dihexadec_9_enoyl_				
ppa_c	propanoate				
etma_e	ethylamine				
trnaglu_c	tRNA_Glu_				
dtdp4d6dg_c	dTDP_4_dehydro_6_deoxy_D_glucose				
2kdrib_p	2_deoxy_D_ribose				
o2_c	O2				
ptrc_e	putrescine				
anhMurNAc_c	1_6_anhydro_N_acetylmuramate				
o2_e	O2				
thisthifads_c	thiS_thiF_acyl_disulfide				
ptrc_c	putrescine				
dcacoa_c	decanoyl_CoA				
nadp_c	NADP_				
tpalm2eACP_c	trans_hexadec_2_enoyl__acyl_carrier_protein_				
kdo2lipid4L_c	KDO2__lauroyl__lipid_IVA				
2ombzl_c	2_octaprenyl_6_methoxy_1_4_benzoquinol				
o2_p	O2				
34hpp_c	4_hydroxyphenylpyruvate				
acgluacetmurpentpeptdpdcp_c	N_acetylglucosamine__N_acetylmuramyl__pentapeptide__pyrophosphoryl_undecaprenol				
thmmp_c	thiamine_phosphate				
dtpcpentpp_c	di_trans_poly_cis_pentaprenyl_diphosphate				
amob_c	S__adenosyl_4_methylthio_2_oxobutanoate				
alac_S_c	2_acetolactate				
cdp_c	CDP				
2oph_c	2_octaprenylphenol				
3otdcoa_c	3_oxotetradecanoyl_CoA				
pgp180_c	phosphatidylglycerolphosphate_dioctadecanoyl_				
ohpb_c	2_oxo_3_hydroxy_4_phosphobutanoate				
GlcNacanhMurNacAlagGlucDAPAla_c	GlcNAc_1_6_anhMurNAc_L_Ala_gamma_D_Glu_DAP_D_Ala				
dha_e	glycerone				
25aics_c	5__phosphoribosyl_4__N_succinocarboxamide__5_aminoimidazole				
mesaccoa_c	mesaconyl_CoA				
sertrna_c	L_seryl_tRNA_Ser_				
cmpkdo_c	CMP_3_deoxy_D_manno_octulosonate				
tdcoa_c	tetradecanoyl_CoA				
dha_p	glycerone				
3htdcoa_c	3S__3_hydroxytetradecanoyl_CoA				
atp_c	ATP				
dutp_c	dUTP				
3octd7ecoa_c	3_oxo_cis_tetradec_7_enoyl_CoA				
cd3ecoa_c	cis_dec_3_enoyl_CoA				
octeACP_c	octadec_9_enoyl__acyl_carrier_protein_				
phyn_c	phytoene				
dha_c	glycerone				
phyn_e	phytoene				
1agpc180_c	1_octadecanoyl_sn_glycero_3_phosphocholine				
hgbyr_c	hydrogenobyrinate				
R_3hocoa_c	3R__3_hydroxyoctanoyl_CoA				
etoh_p	ethanol				
ara5p_c	D_arabinose_5_phosphate				
citr_L_c	L_citrulline				
etoh_e	ethanol				
t2coctd11ecoa_c	trans_2_cis_11_octadecenoyl_CoA				
coa_c	CoA				
dvpclphd_c	divinyl_protochlorophyllidea				
gar_c	5_phospho_ribosyl_glycineamide				
malt_c	maltose				
palmACP_c	hexadecanoyl__acyl_carrier_protein_				
ocdcap_c	octadecanoyl_phosphate				
D_araba_e	D_arabinonate				
h2pt_c	6_7_dihydropteridine				
g1p_c	D_glucose_1_phosphate				
rdvbin_c	rhodovibrin				
u3hga_c	UDP_3_O__3_hydroxymyristoyl_glucosamine				
3odecACP_c	3_oxodecanoyl__acyl_carrier_protein_				
3hoctaACP_c	3R__3_hydroxyoctadecanoyl__acyl_carrier_protein_				
lac_D_c	D_lactate				
pa161_c	1_2_dihexadec_9_enoyl_sn_glycerol_3_phosphate				
imp_c	IMP				
t23dh3hxanth_c	trans_2_3_dihydro_3_hydroxyanthranilate				
etoh_c	ethanol				
oxEA_c	oxidized_electron_acceptor				
oxEA_e	oxidized_electron_acceptor				
fc1p_c	L_fuculose_1_phosphate				
qh2_c	UQH2				
1odecg3p_c	1_octadecanoyl_sn_glycerol_3_phosphate				
D_araba_p	D_arabinonate				
xan_c	xanthine				
trnatrp_c	tRNA_Trp_				
2driboa_p	2_deoxy_D_ribonate				
arab_L_e	L_arabinose				
nadph_c	NADPH				
pre3b_c	precorrin_3B				
2obut_c	2_oxobutanoate				
uagmda_c	N_acetylmuramoyl_L_alanyl_D_glutamyl_meso_2_6_diaminopimelyl_D_alanyl_D_alanine_diphosphoundecaprenol				
Gcvpdhll_c	H_Gcv_protein__dihydrolipoyl_lysine				
indole_c	indole				
5fh4mpt_c	5_formyltetrahydromethanopterin				
splxanth_c	spirilloxanthin				
3ctd7ecoa_c	cis_3_cis_7_tetradecenoyl_CoA				
1agpe180_c	1_octadecanoyl_sn_glycero_3_phosphoethanolamine				
mercppyr_c	3_mercaptopyruvate				
cu2_c	Cu2_				
adp_c	ADP				
asptrna_c	L_aspartyl_tRNA_Asp_				
aacoa_c	acetoacetyl_CoA				
cu2_e	Cu2_				
frdp_c	all_trans_farnesyl_diphosphate				
mn2_c	Mn2_				
cu2_p	Cu2_				
dd2coa_c	trans_dodec_2_enoyl_CoA				
mn2_e	Mn2_				
3ohcoa_c	3_oxohexanoyl_CoA				
2driboa_e	2_deoxy_D_ribonate				
g3pc_c	sn_glycero_3_phosphocholine				
dtmp_c	dTMP				
for_c	formate				
mthgxl_c	methylglyoxal				
ser_L_c	L_serine				
mn2_p	Mn2_				
ggdp_c	all_trans_geranyl_geranyl_diphosphate				
1agpc161_c	1_hexadec_9_enoyl_sn_glycero_3_phosphocholine				
for_e	formate				
2p4c2me_c	2_phospho_4__cytidine_5__diphospho__2_C_methyl_D_erythritol				
Nndmetphenda_c	N_N__dimethyl_p_phenylenediamine				
hxa_c	hexanoate				
pphn_c	prephenate				
pdx5p_c	pyridoxine_5__phosphate				
acorn_c	N_acetyl_L_ornithine				
5mdr1p_iso_c	S__methyl_5_thio_D_ribulose_1_phosphate				
2dhp_c	2_dehydropantoate				
ile_L_c	L_isoleucine				
2chmac_c	2_chloromaleylacetate				
actACP_c	acetoacetyl__acyl_carrier_protein_				
4mlacac_c	4_maleyl_acetoacetate				
mal_L_p	S__malate				
mal_L_e	S__malate				
3ig3p_c	indole_3_glycerol_phosphate				
4hbz_c	4_hydroxybenzoate				
pa180_c	1_2_dioctadecanoyl_sn_glycerol_3_phosphate				
pran_c	N__5_phospho_beta_D_ribosyl__anthranilate				
gdp_c	GDP				
stcoa_c	octadecanoyl_CoA				
gam1p_c	D_glucosamine_1_phosphate				
mal_L_c	S__malate				
pheme_c	protoheme_IX				
3c3hmp_c	3_isopropylmalate				
arab_L_p	L_arabinose				
mobd_p	molybdate				
udpglcur_c	UDP_glucuronate				
sl2a6o_c	N_succinyl_2_amino_6_ketopimelate				
anrdvbin_c	anhydrorhodovibrin				
3hodcoa_c	3S__3_hydroxyoctadecanoyl_CoA				
fmnh2_c	FMNH2				
asp_L_p	L_aspartate				
inost_c	myo_inositol				
dump_c	dUMP				
mocogdp_c	molybdopterin_guanine_dinucleotide				
kdo2lipid4_c	KDO2_lipid_IVA				
mobd_c	molybdate				
mobd_e	molybdate				
no3_e	NO3_				
no3_c	NO3_				
h2s_c	H2S				
hdcap_c	hexadecanoyl_phosphate				
cystrna_c	L_cysteinyl_tRNA_Cys_				
ttc_ggdp_c	2_cis_6_trans_10_trans_geranylgeranyl_diphosphate				
no3_p	NO3_				
h2o_p	H2O				
udpidour_c	UDP_L_iduronate				
h2o_e	H2O				
cdpglc_c	CDP_glucose				
tmrs2eACP_c	trans_tetradec_2_enoyl__acyl_carrier_protein_				
f6p_c	D_fructose_6_phosphate				
1agpe161_c	1_hexadec_9_enoyl_sn_glycero_3_phosphoethanolamine				
bhb_c	R__3_hydroxybutanoate				
h2o_c	H2O				
cpppg3_c	coproporphyrinogen_III				
dtpcnonpp_c	di_trans_poly_cis_nonaprenyldiphosphate				
oxETF_c	oxidized_ETF				
pydx5p_c	pyridoxal_5__phosphate				
2ohph_c	2_octaprenyl_6_hydroxyphenol				
trnaarg_c	tRNA_Arg_				
glccrm_c	D_glucosyl_ceramide				
dmbzid_c	dimethylbenzimidazole				
h2o2_c	H2O2				
tre6p_c	trehalose_6_phosphate				
ficytc_c	oxidized_cytochrome_c				
r3hbcoa_c	R__3_hydroxybutanoyl_CoA				
R_3hoct_c	3R__3_hydroxyoctanoate				
h2o2_e	H2O2				
ao4pob_c	2S__2_amino_3_oxo_4_phosphonooxybutanoate				
dtpcudcpp_c	di_trans_poly_cis_undecaprenyl_diphosphate				
h_p	H_				
for_p	formate				
glu5sa_c	L_glutamate_gamma_semialdehyde				
h2o2_p	H2O2				
cd2ecoa_c	cis_dec_2_enoyl_CoA				
udcpp_c	di_trans_poly_cis_undecaprenyl_phosphate				
ddcaACP_c	dodecanoyl__acyl_carrier_protein_				
tdecoa_c	cis_tetradec_7_enoyl_CoA				
trdox_c	oxidized_thioredoxin				
skm3p_c	shikimate_3_phosphate				
ppp9_c	protoporphyrin_IX				
galcDaraba_e	3_O_b_D_galactopyranosyl_D_arabinonate				
R_3hdc_c	3R__3_hydroxydecanoate				
rdpin_c	rhodopin				
galcDaraba_p	3_O_b_D_galactopyranosyl_D_arabinonate				
fgam_c	5__phosphoribosyl_N_formylglycineamide				
hdeACP_c	hexadec_9_enoyl__acyl_carrier_protein_				
4per_c	erythronate_4_phosphate				
h_c	H_				
h_e	H_				
hxcoa_c	hexanoyl_CoA				
skm_c	shikimate				
ch4_e	methane	0	CH4	InChI=1S/CH4/h1H4	UPA:UPC01438
ch4_p	methane	0	CH4	InChI=1S/CH4/h1H4	UPA:UPC01438
n2_c	dinitrogen	0	N2	InChI=1S/N2/c1-2	UPA:UPC00697
n2_p	dinitrogen	0	N2	InChI=1S/N2/c1-2	UPA:UPC00697
n2_e	dinitrogen	0	N2	InChI=1S/N2/c1-2	UPA:UPC00697
no2_e	nitrite	-1	NO2	InChI=1S/HNO2/c2-1-3/h(H,2,3)/p-1	UPA:UPC00088
ham_c	hydroxylamine	0	H3NO	InChI=1S/H3NO/c1-2/h2H,1H2	
ham_p	hydroxylamine	0	H3NO	InChI=1S/H3NO/c1-2/h2H,1H2	
h2_c	H2	0	H2		UPA:UPC00282
ch4_c	methane	0	CH4	InChI=1S/CH4/h1H4	UPA:UPC01438
meoh_c	methanol	0	CH4O1	InChI=1S/CH4O/c1-2/h2H,1H3	UPA:UPC00132
acmum6p_c	N-acetylmuramate 6-phosphate	-3	C11H17NO11P		
anhm_c	1,6-anhydrous-N-Acetylmuramate	-1	C11H16NO7		
met__L_c	L-methionine zwitterion	0	C5H11NO2S	InChI=1S/C5H11NO2S/c1-9-3-2-4(6)5(7)8/h4H,2-3,6H2,1H3,(H,7,8)/t4-/m0/s1	UPA:UPC00073
metsox_R__L_c	L-methionine-R-sulfoxide	0	C5H11NO3S		
uacmam_c	UDP-N-acetyl-D-mannosamine	-2	C17H25N3O17P2		
uacmamu_c	UDP-N-acetyl-D-mannosaminouronate	-3	C17H22N3O18P2		
idp_c	IDP	-3	C10H11N4O11P2		
itp_c	ITP(3-)	-4	C10H11N4O14P3	InChI=1S/C10H15N4O14P3/c15-6-4(1-25-30(21,22)28-31(23,24)27-29(18,19)20)26-10(7(6)16)14-3-13-5-8(14)11-2-12-9(5)17/h2-4,6-7,10,15-16H,1H2,(H,21,22)(H,23,24)(H,11,12,17)(H2,18,19,20)/p-3/t4-,6-,7-,10-/m1/s1	
didp_c	dIDP	-3	C10H11N4O10P2		
ditp_c	dITP	-4	C10H11N4O13P3		
2fe2s_c	[2Fe-2S] iron-sulfur cluster	2	S2Fe2		
4fe4s_c	[4Fe-4S] iron-sulfur cluster	2	S4Fe4		
dad_5_c	5'-deoxyadenosine	0	C10H13N5O3	InChI=1S/C10H13N5O3/c1-4-6(16)7(17)10(18-4)15-3-14-5-8(11)12-2-13-9(5)15/h2-4,6-7,10,16-17H,1H3,(H2,11,12,13)/t4-,6-,7-,10-/m1/s1	UPA:UPC05198
lipopb_c	Lipoate (protein bound)	1	C8H13OS2		
octapb_c	Octanoate (protein bound)	1	C8H15O		
cgly_c	L-cysteinylglycine	0	C5H10N2O3S	InChI=1S/C5H10N2O3S/c6-3(2-11)5(10)7-1-4(8)9/h3,11H,1-2,6H2,(H,7,10)(H,8,9)/t3-/m0/s1	
glu__L_c	L-glutamate	-1	C5H8NO4	InChI=1S/C5H9NO4/c6-3(5(9)10)1-2-4(7)8/h3H,1-2,6H2,(H,7,8)(H,9,10)/p-1/t3-/m0/s1	UPA:UPC00025
lhcys_c	L-homocysteine	0	C4H9NO2S		
3hpp_c	3-Hydroxypropanoate	-1	C3H5O3		
msa_c	Malonate semialdehyde	-1	C3H3O3		
btamp_c	biotinyl-5'-AMP	-1	C20H27N7O9PS	InChI=1S/C20H28N7O9PS/c21-17-14-18(23-7-22-17)27(8-24-14)19-16(30)15(29)10(35-19)5-34-37(32,33)36-12(28)4-2-1-3-11-13-9(6-38-11)25-20(31)26-13/h7-11,13,15-16,19,29-30H,1-6H2,(H,32,33)(H2,21,22,23)(H2,25,26,31)/p-1/t9-,10+,11-,13-,15+,16+,19+/m0/s1	
hgentis_c	Homogentisate C8H7O4	0	C8H7O4		
5fthf_c	5-Formyltetrahydrofolate	-2	C20H21N7O7		
udpLa4o_c	UDP-4-keto-pyranose	-2	C14H18N2O16P2		
hcit_c	(2R)-homocitrate	-3	C7H7O7	InChI=1S/C7H10O7/c8-4(9)1-2-7(14,6(12)13)3-5(10)11/h14H,1-3H2,(H,8,9)(H,10,11)(H,12,13)/p-3/t7-/m1/s1	UPA:UPC01251
dgsn_c	Deoxyguanosine	0	C10H13N5O4		
4h2opntn_c	4-Hydroxy-2-oxopentanoate	0	C5H7O4		
cdg_c	7-deaza-7-carboxyguanine	-1	C7H5N4O3		
preq0_c	7-cyano-7-deazaguanine	0	C7H5N5O	InChI=1S/C7H5N5O/c8-1-3-2-10-5-4(3)6(13)12-7(9)11-5/h2H,(H4,9,10,11,12,13)	UPA:UPC15996
ala__D_c	D-Alanine	0	C3H7NO2		
hmgcoa_c	Hydroxymethylglutaryl CoA C27H39N7O20P3S	0	C27H39N7O20P3S		
fru_c	D-Fructose	0	C6H12O6		
dplpt_c	hop-22(29)-ene	0	C30H50	InChI=1S/C30H50/c1-20(2)21-12-17-27(5)22(21)13-18-29(7)24(27)10-11-25-28(6)16-9-15-26(3,4)23(28)14-19-30(25,29)8/h21-25H,1,9-19H2,2-8H3/t21-,22+,23+,24-,25-,27+,28+,29-,30-/m1/s1	
sql_c	squalene	0	C30H50	InChI=1S/C30H50/c1-25(2)15-11-19-29(7)23-13-21-27(5)17-9-10-18-28(6)22-14-24-30(8)20-12-16-26(3)4/h15-18,23-24H,9-14,19-22H2,1-8H3/b27-17+,28-18+,29-23+,30-24+	UPA:UPC00751
dpterol_c	hopan-22-ol	0	C30H52O	InChI=1S/C30H52O/c1-25(2)15-9-16-28(6)22(25)14-19-30(8)24(28)11-10-23-27(5)17-12-20(26(3,4)31)21(27)13-18-29(23,30)7/h20-24,31H,9-19H2,1-8H3/t20-,21-,22-,23+,24+,27-,28-,29+,30+/m0/s1	
lac__D_c	D-Lactate	-1	C3H5O3		
betald_c	Betaine aldehyde	1	C5H12NO		
ch4s_c	Methanethiol CH4S	0	CH4S		
ala__L_c	L-alanine zwitterion	0	C3H7NO2	InChI=1S/C3H7NO2/c1-2(4)3(5)6/h2H,4H2,1H3,(H,5,6)/t2-/m0/s1	UPA:UPC00041
cys__L_c	L-cysteine zwitterion	0	C3H7NO2S	InChI=1S/C3H7NO2S/c4-2(1-7)3(5)6/h2,7H,1,4H2,(H,5,6)/t2-/m0/s1	UPA:UPC00097
sufse_c	SufSE sulfur acceptor complex	0	HSR		
sufsesh_c	SufSE with bound sulfur	0	HS2R		
mococdp_c	Molybdopterin cytosine dinucleotide	-2	C19H22N8O15P2S2Mo		
2mcacn_c	Cis-2-Methylaconitate	-3	C7H5O6		
2mcit_c	2-Methylcitrate	-3	C7H7O7		
nmn_c	beta-nicotinamide D-ribonucleotide	-1	C11H14N2O8P	InChI=1S/C11H15N2O8P/c12-10(16)6-2-1-3-13(4-6)11-9(15)8(14)7(21-11)5-20-22(17,18)19/h1-4,7-9,11,14-15H,5H2,(H3-,12,16,17,18,19)/p-1/t7-,8-,9-,11-/m1/s1	UPA:UPC00455
n2o_c					
ficytcc555_p	ferricytochrome c	3	C42H54FeN8O6S2		UPA:UPC00125
focytcc555_p	ferrocytochrome c	2	C42H54FeN8O6S2		UPA:UPC00126
accoaa_c					
accoab_c					
